GGGGGGGGGGGGGGGGGGGGGGG
GGGGGGGGGGGGGGGGGGGGGGG
GGGGLLLLLLLLLLLLGGGGGGG
GGGGLLLLLLLLLLLLGGGGGGG
GGGGLLLLLLLLLLLLGGCCCCC
GGGGLLLLLLLLLLLLGGCSSSS
GGGGLLLLLLLLLLLLLLCSSSS
GGGGLLLLLLLLLLLLGGCSSSS
GGGGLLLLLLLLLLLLGGCCCCC
GGGGLLLLLLLLLLLLGGGGGGG
GGGGGGGGGGGGGGGGGGGGGGG
GGGGGGGGGGGGGGGGGGGGGGG