GGGTGGGGGGTGGGGGGGTGGGG
GGGGGGGGGGGGGGGGGGGGGGG
GGGGLLLLLLLLLLLLGGGTGGG
GTGGLLLLLLLLLLLLGTGGGGG
GGGGLLLLLLLLLLLLGGCCCCC
GGGGLLLLLLLLLLLLGGCSSSS
GGTGLLLLLLLLLLLLLLCSSSS
GGGGLLLLLLLLLLLLGGCSSSS
TGGGLLLLLLLLLLLLGGCCCCC
GGGGLLLLLLLLLLLLGGGGGTG
GGGGGGGGGGGGGGTGGGGGGGG
GTGGGGGGTGGGGGGGGGTGGGG