2222211111111113333333
12GGGGGGGGGGGGGGGGGGG3
12GGLLLLLLLLLLLG5GGG33
1GGGLLLLLLLLLLLGGG5G33
24GGLLLLLLLLLLLGGCCCCC
2GGGLLLLLLLLLLLGGCSSSS
22GGLLLLLLLLLLLLLCSSSS
2GGGLLLLLLLLLLLGGCSSSS
14GGLLLLLLLLLLLGGCCCCC
1G1GLLLLLLLLLLLG5GGG33
12GGGGGGGGGGGGGGGGGG33
2222211111111113333333