GGGGGGGGGGGGGGGGGGGGGG
GGGGGGGGGGGGGGGGGGGGGG
GGGGLLLLLLLLLLLGGGGGGG
GGGGLLLLLLLLLLLGGGGGGG
GGGGLLLLLLLLLLLLLCCCCC
GGGGLLLLLLLLLLLLLCSSSS
GGGGLLLLLLLLLLLLLCSSSS
GGGGLLLLLLLLLLLLLCSSSS
GGGGLLLLLLLLLLLLLCCCCC
GGGGLLLLLLLLLLLGGGGGGG
GGGGGGGGGGGGGGGGGGGGGG
GGGGGGGGGGGGGGGGGGGGGG