2222211111111113333333
12GGGGGGGGGGGGGGGGGGG3
12GGLLLLLLLLLLLG5GGG33
1GGGLLLLLLLLLLLGGG5G33
24GGLLLLLLLLLLLLLCCCCC
2GGGLLLLLLLLLLLLLCSSSS
22GGLLLLLLLLLLLLLCSSSS
2GGGLLLLLLLLLLLLLCSSSS
14GGLLLLLLLLLLLLLCCCCC
1G1GLLLLLLLLLLLG5GGG33
12GGGGGGGGGGGGGGGGGG33
2222211111111113333333